##########
#.#....#.#
#..E..E..#
#..#.P.#.#
#........#
#..E.....#
##########
