##########
#P#..#..E#
#.#.##.#.#
#..#..#..#
#.##..##.#
#E......E#
##########