##########
#........#
#..E.....#
#....P...#
#........#
#......E.#
##########
